---------
-m -p-  -
-  - -  -
-m      -
---------